MMM	3M Company	Industrials
AOS	A. O. Smith Corporation	Industrials
ABT	Abbott Laboratories	Health Care
ABBV	AbbVie Inc.	Health Care
ABMD	ABIOMED Inc.	Health Care
ACN	Accenture Plc Class A	Information Technology
ATVI	Activision Blizzard Inc.	Communication Services
ADBE	Adobe Inc.	Information Technology
AAP	Advance Auto Parts Inc.	Consumer Discretionary
AMD	Advanced Micro Devices Inc.	Information Technology
AES	AES Corporation	Utilities
AMG	Affiliated Managers Group Inc.	Financials
AFL	Aflac Incorporated	Financials
A	Agilent Technologies Inc.	Health Care
APD	Air Products and Chemicals Inc.	Materials
AKAM	Akamai Technologies Inc.	Information Technology
ALK	Alaska Air Group Inc.	Industrials
ALB	Albemarle Corporation	Materials
ARE	Alexandria Real Estate Equities Inc.	Real Estate
ALXN	Alexion Pharmaceuticals Inc.	Health Care
ALGN	Align Technology Inc.	Health Care
ALLE	Allegion PLC	Industrials
AGN	Allergan plc	Health Care
ADS	Alliance Data Systems Corporation	Information Technology
LNT	Alliant Energy Corp	Utilities
ALL	Allstate Corporation	Financials
GOOGL	Alphabet Inc. Class A	Communication Services
GOOG	Alphabet Inc. Class C	Communication Services
MO	Altria Group Inc	Consumer Staples
AMZN	Amazon.com Inc.	Consumer Discretionary
AEE	Ameren Corporation	Utilities
AAL	American Airlines Group Inc.	Industrials
AEP	American Electric Power Company Inc.	Utilities
AXP	American Express Company	Financials
AIG	American International Group Inc.	Financials
AMT	American Tower Corporation	Real Estate
AWK	American Water Works Company Inc.	Utilities
AMP	Ameriprise Financial Inc.	Financials
ABC	AmerisourceBergen Corporation	Health Care
AME	AMETEK Inc.	Industrials
AMGN	Amgen Inc.	Health Care
APH	Amphenol Corporation Class A	Information Technology
APC	Anadarko Petroleum Corporation	Energy
ADI	Analog Devices Inc.	Information Technology
ANSS	ANSYS Inc.	Information Technology
ANTM	Anthem Inc.	Health Care
AON	Aon plc	Financials
APA	Apache Corporation	Energy
AIV	Apartment Investment and Management Company Class A	Real Estate
AAPL	Apple Inc.	Information Technology
AMAT	Applied Materials Inc.	Information Technology
APTV	Aptiv PLC	Consumer Discretionary
ADM	Archer-Daniels-Midland Company	Consumer Staples
ARNC	Arconic Inc.	Industrials
ANET	Arista Networks Inc.	Information Technology
AJG	Arthur J. Gallagher & Co.	Financials
AIZ	Assurant Inc.	Financials
T	AT&T Inc.	Communication Services
ATO	Atmos Energy Corporation	Utilities
ADSK	Autodesk Inc.	Information Technology
ADP	Automatic Data Processing Inc.	Information Technology
AZO	AutoZone Inc.	Consumer Discretionary
AVB	AvalonBay Communities Inc.	Real Estate
AVY	Avery Dennison Corporation	Materials
BHGE	Baker Hughes a GE Company Class A	Energy
BLL	Ball Corporation	Materials
BAC	Bank of America Corp	Financials
BK	Bank of New York Mellon Corporation	Financials
BAX	Baxter International Inc.	Health Care
BBT	BB&T Corporation	Financials
BDX	Becton Dickinson and Company	Health Care
BRK.B	Berkshire Hathaway Inc. Class B	Financials
BBY	Best Buy Co. Inc.	Consumer Discretionary
BIIB	Biogen Inc.	Health Care
BLK	BlackRock Inc.	Financials
BA	Boeing Company	Industrials
BKNG	Booking Holdings Inc.	Consumer Discretionary
BWA	BorgWarner Inc.	Consumer Discretionary
BXP	Boston Properties Inc.	Real Estate
BSX	Boston Scientific Corporation	Health Care
BMY	Bristol-Myers Squibb Company	Health Care
AVGO	Broadcom Inc.	Information Technology
BR	Broadridge Financial Solutions Inc.	Information Technology
BF.B	Brown-Forman Corporation Class B	Consumer Staples
CHRW	C.H. Robinson Worldwide Inc.	Industrials
COG	Cabot Oil & Gas Corporation	Energy
CDNS	Cadence Design Systems Inc.	Information Technology
CPB	Campbell Soup Company	Consumer Staples
COF	Capital One Financial Corporation	Financials
CPRI	Capri Holdings Limited	Consumer Discretionary
CAH	Cardinal Health Inc.	Health Care
KMX	CarMax Inc.	Consumer Discretionary
CCL	Carnival Corporation	Consumer Discretionary
CAT	Caterpillar Inc.	Industrials
CBOE	Cboe Global Markets Inc	Financials
CBRE	CBRE Group Inc. Class A	Real Estate
CBS	CBS Corporation Class B	Communication Services
CE	Celanese Corporation	Materials
CELG	Celgene Corporation	Health Care
CNC	Centene Corporation	Health Care
CNP	CenterPoint Energy Inc.	Utilities
CTL	CenturyLink Inc.	Communication Services
CERN	Cerner Corporation	Health Care
CF	CF Industries Holdings Inc.	Materials
SCHW	Charles Schwab Corporation	Financials
CHTR	Charter Communications Inc. Class A	Communication Services
CVX	Chevron Corporation	Energy
CMG	Chipotle Mexican Grill Inc.	Consumer Discretionary
CB	Chubb Limited	Financials
CHD	Church & Dwight Co. Inc.	Consumer Staples
CI	Cigna Corporation	Health Care
XEC	Cimarex Energy Co.	Energy
CINF	Cincinnati Financial Corporation	Financials
CTAS	Cintas Corporation	Industrials
CSCO	Cisco Systems Inc.	Information Technology
C	Citigroup Inc.	Financials
CFG	Citizens Financial Group Inc.	Financials
CTXS	Citrix Systems Inc.	Information Technology
CLX	Clorox Company	Consumer Staples
CME	CME Group Inc. Class A	Financials
CMS	CMS Energy Corporation	Utilities
KO	Coca-Cola Company	Consumer Staples
CTSH	Cognizant Technology Solutions Corporation Class A	Information Technology
CL	Colgate-Palmolive Company	Consumer Staples
CMCSA	Comcast Corporation Class A	Communication Services
CMA	Comerica Incorporated	Financials
CAG	Conagra Brands Inc.	Consumer Staples
CXO	Concho Resources Inc.	Energy
COP	ConocoPhillips	Energy
ED	Consolidated Edison Inc.	Utilities
STZ	Constellation Brands Inc. Class A	Consumer Staples
COO	Cooper Companies Inc.	Health Care
CPRT	Copart Inc.	Industrials
GLW	Corning Inc	Information Technology
COST	Costco Wholesale Corporation	Consumer Staples
COTY	Coty Inc. Class A	Consumer Staples
CCI	Crown Castle International Corp	Real Estate
CSX	CSX Corporation	Industrials
CMI	Cummins Inc.	Industrials
CVS	CVS Health Corporation	Health Care
DHI	D.R. Horton Inc.	Consumer Discretionary
DHR	Danaher Corporation	Health Care
DRI	Darden Restaurants Inc.	Consumer Discretionary
DVA	DaVita Inc.	Health Care
DE	Deere & Company	Industrials
DAL	Delta Air Lines Inc.	Industrials
XRAY	DENTSPLY SIRONA Inc.	Health Care
DVN	Devon Energy Corporation	Energy
FANG	Diamondback Energy Inc.	Energy
DLR	Digital Realty Trust Inc.	Real Estate
DFS	Discover Financial Services	Financials
DISCA	Discovery Inc. Class A	Communication Services
DISCK	Discovery Inc. Class C	Communication Services
DISH	DISH Network Corporation Class A	Communication Services
DG	Dollar General Corporation	Consumer Discretionary
DLTR	Dollar Tree Inc.	Consumer Discretionary
D	Dominion Energy Inc	Utilities
DOV	Dover Corporation	Industrials
DOW	Dow Inc.	Materials
DWDP	DowDuPont Inc.	Materials
DTE	DTE Energy Company	Utilities
DUK	Duke Energy Corporation	Utilities
DRE	Duke Realty Corporation	Real Estate
DXC	DXC Technology Co.	Information Technology
ETFC	E*TRADE Financial Corporation	Financials
EMN	Eastman Chemical Company	Materials
ETN	Eaton Corp. Plc	Industrials
EBAY	eBay Inc.	Consumer Discretionary
ECL	Ecolab Inc.	Materials
EIX	Edison International	Utilities
EW	Edwards Lifesciences Corporation	Health Care
EA	Electronic Arts Inc.	Communication Services
LLY	Eli Lilly and Company	Health Care
EMR	Emerson Electric Co.	Industrials
ETR	Entergy Corporation	Utilities
EOG	EOG Resources Inc.	Energy
EFX	Equifax Inc.	Industrials
EQIX	Equinix Inc.	Real Estate
EQR	Equity Residential	Real Estate
ESS	Essex Property Trust Inc.	Real Estate
EL	Estee Lauder Companies Inc. Class A	Consumer Staples
RE	Everest Re Group Ltd.	Financials
EVRG	Evergy Inc.	Utilities
ES	Eversource Energy	Utilities
EXC	Exelon Corporation	Utilities
EXPE	Expedia Group Inc.	Consumer Discretionary
EXPD	Expeditors International of Washington Inc.	Industrials
EXR	Extra Space Storage Inc.	Real Estate
XOM	Exxon Mobil Corporation	Energy
FFIV	F5 Networks Inc.	Information Technology
FB	Facebook Inc. Class A	Communication Services
FAST	Fastenal Company	Industrials
FRT	Federal Realty Investment Trust	Real Estate
FDX	FedEx Corporation	Industrials
FIS	Fidelity National Information Services Inc.	Information Technology
FITB	Fifth Third Bancorp	Financials
FRC	First Republic Bank	Financials
FE	FirstEnergy Corp.	Utilities
FISV	Fiserv Inc.	Information Technology
FLT	FleetCor Technologies Inc.	Information Technology
FLIR	FLIR Systems Inc.	Information Technology
FLS	Flowserve Corporation	Industrials
FLR	Fluor Corporation	Industrials
FMC	FMC Corporation	Materials
FL	Foot Locker Inc.	Consumer Discretionary
F	Ford Motor Company	Consumer Discretionary
FTNT	Fortinet Inc.	Information Technology
FTV	Fortive Corp.	Industrials
FBHS	Fortune Brands Home & Security Inc.	Industrials
FOXA	Fox Corporation Class A	Communication Services
FOX	Fox Corporation Class B	Communication Services
BEN	Franklin Resources Inc.	Financials
FCX	Freeport-McMoRan Inc.	Materials
GPS	Gap Inc.	Consumer Discretionary
GRMN	Garmin Ltd.	Consumer Discretionary
IT	Gartner Inc.	Information Technology
GD	General Dynamics Corporation	Industrials
GE	General Electric Company	Industrials
GIS	General Mills Inc.	Consumer Staples
GM	General Motors Company	Consumer Discretionary
GPC	Genuine Parts Company	Consumer Discretionary
GILD	Gilead Sciences Inc.	Health Care
GPN	Global Payments Inc.	Information Technology
GS	Goldman Sachs Group Inc.	Financials
HRB	H&R Block Inc.	Consumer Discretionary
HAL	Halliburton Company	Energy
HBI	Hanesbrands Inc.	Consumer Discretionary
HOG	Harley-Davidson Inc.	Consumer Discretionary
HRS	Harris Corporation	Industrials
HIG	Hartford Financial Services Group Inc.	Financials
HAS	Hasbro Inc.	Consumer Discretionary
HCA	HCA Healthcare Inc	Health Care
HCP	HCP Inc.	Real Estate
HP	Helmerich & Payne Inc.	Energy
HSIC	Henry Schein Inc.	Health Care
HSY	Hershey Company	Consumer Staples
HES	Hess Corporation	Energy
HPE	Hewlett Packard Enterprise Co.	Information Technology
HLT	Hilton Worldwide Holdings Inc	Consumer Discretionary
HFC	HollyFrontier Corporation	Energy
HOLX	Hologic Inc.	Health Care
HD	Home Depot Inc.	Consumer Discretionary
HON	Honeywell International Inc.	Industrials
HRL	Hormel Foods Corporation	Consumer Staples
HST	Host Hotels & Resorts Inc.	Real Estate
HPQ	HP Inc.	Information Technology
HUM	Humana Inc.	Health Care
HBAN	Huntington Bancshares Incorporated	Financials
HII	Huntington Ingalls Industries Inc.	Industrials
IDXX	IDEXX Laboratories Inc.	Health Care
INFO	IHS Markit Ltd.	Industrials
ITW	Illinois Tool Works Inc.	Industrials
ILMN	Illumina Inc.	Health Care
INCY	Incyte Corporation	Health Care
IR	Ingersoll-Rand Plc	Industrials
INTC	Intel Corporation	Information Technology
ICE	Intercontinental Exchange Inc.	Financials
IBM	International Business Machines Corporation	Information Technology
IFF	International Flavors & Fragrances Inc.	Materials
IP	International Paper Company	Materials
IPG	Interpublic Group of Companies Inc.	Communication Services
INTU	Intuit Inc.	Information Technology
ISRG	Intuitive Surgical Inc.	Health Care
IVZ	Invesco Ltd.	Financials
IPGP	IPG Photonics Corporation	Information Technology
IQV	IQVIA Holdings Inc	Health Care
IRM	Iron Mountain Inc.	Real Estate
JBHT	J.B. Hunt Transport Services Inc.	Industrials
SJM	J.M. Smucker Company	Consumer Staples
JKHY	Jack Henry & Associates Inc.	Information Technology
JEC	Jacobs Engineering Group Inc.	Industrials
JEF	Jefferies Financial Group Inc.	Financials
JNJ	Johnson & Johnson	Health Care
JCI	Johnson Controls International plc	Industrials
JPM	JPMorgan Chase & Co.	Financials
JNPR	Juniper Networks Inc.	Information Technology
KSU	Kansas City Southern	Industrials
K	Kellogg Company	Consumer Staples
KEY	KeyCorp	Financials
KEYS	Keysight Technologies Inc	Information Technology
KMB	Kimberly-Clark Corporation	Consumer Staples
KIM	Kimco Realty Corporation	Real Estate
KMI	Kinder Morgan Inc Class P	Energy
KLAC	KLA-Tencor Corporation	Information Technology
KSS	Kohl's Corporation	Consumer Discretionary
KHC	Kraft Heinz Company	Consumer Staples
KR	Kroger Co.	Consumer Staples
LB	L Brands Inc.	Consumer Discretionary
LLL	L3 Technologies Inc	Industrials
LH	Laboratory Corporation of America Holdings	Health Care
LRCX	Lam Research Corporation	Information Technology
LW	Lamb Weston Holdings Inc.	Consumer Staples
LEG	Leggett & Platt Incorporated	Consumer Discretionary
LEN	Lennar Corporation Class A	Consumer Discretionary
LNC	Lincoln National Corporation	Financials
LIN	Linde plc	Materials
LKQ	LKQ Corporation	Consumer Discretionary
LMT	Lockheed Martin Corporation	Industrials
L	Loews Corporation	Financials
LOW	Lowe's Companies Inc.	Consumer Discretionary
LYB	LyondellBasell Industries NV	Materials
MTB	M&T Bank Corporation	Financials
MAC	Macerich Company	Real Estate
M	Macy's Inc	Consumer Discretionary
MRO	Marathon Oil Corporation	Energy
MPC	Marathon Petroleum Corporation	Energy
MAR	Marriott International Inc. Class A	Consumer Discretionary
MMC	Marsh & McLennan Companies Inc.	Financials
MLM	Martin Marietta Materials Inc.	Materials
MAS	Masco Corporation	Industrials
MA	Mastercard Incorporated Class A	Information Technology
MAT	Mattel Inc.	Consumer Discretionary
MXIM	Maxim Integrated Products Inc.	Information Technology
MKC	McCormick & Company Incorporated	Consumer Staples
MCD	McDonald's Corporation	Consumer Discretionary
MCK	McKesson Corporation	Health Care
MDT	Medtronic plc	Health Care
MRK	Merck & Co. Inc.	Health Care
MET	MetLife Inc.	Financials
MTD	Mettler-Toledo International Inc.	Health Care
MGM	MGM Resorts International	Consumer Discretionary
MCHP	Microchip Technology Incorporated	Information Technology
MU	Micron Technology Inc.	Information Technology
MSFT	Microsoft Corporation	Information Technology
MAA	Mid-America Apartment Communities Inc.	Real Estate
MHK	Mohawk Industries Inc.	Consumer Discretionary
TAP	Molson Coors Brewing Company Class B	Consumer Staples
MDLZ	Mondelez International Inc. Class A	Consumer Staples
MNST	Monster Beverage Corporation	Consumer Staples
MCO	Moody's Corporation	Financials
MS	Morgan Stanley	Financials
MOS	Mosaic Company	Materials
MSI	Motorola Solutions Inc.	Information Technology
MSCI	MSCI Inc. Class A	Financials
MYL	Mylan N.V.	Health Care
NDAQ	Nasdaq Inc.	Financials
NOV	National Oilwell Varco Inc.	Energy
NKTR	Nektar Therapeutics	Health Care
NTAP	NetApp Inc.	Information Technology
NFLX	Netflix Inc.	Communication Services
NWL	Newell Brands Inc	Consumer Discretionary
NEM	Newmont Mining Corporation	Materials
NWSA	News Corporation Class A	Communication Services
NWS	News Corporation Class B	Communication Services
NEE	NextEra Energy Inc.	Utilities
NLSN	Nielsen Holdings Plc	Industrials
NKE	NIKE Inc. Class B	Consumer Discretionary
NI	NiSource Inc	Utilities
NBL	Noble Energy Inc.	Energy
JWN	Nordstrom Inc.	Consumer Discretionary
NSC	Norfolk Southern Corporation	Industrials
NTRS	Northern Trust Corporation	Financials
NOC	Northrop Grumman Corporation	Industrials
NCLH	Norwegian Cruise Line Holdings Ltd.	Consumer Discretionary
NRG	NRG Energy Inc.	Utilities
NUE	Nucor Corporation	Materials
NVDA	NVIDIA Corporation	Information Technology
ORLY	O'Reilly Automotive Inc.	Consumer Discretionary
OXY	Occidental Petroleum Corporation	Energy
OMC	Omnicom Group Inc	Communication Services
OKE	ONEOK Inc.	Energy
ORCL	Oracle Corporation	Information Technology
PCAR	PACCAR Inc	Industrials
PKG	Packaging Corporation of America	Materials
PH	Parker-Hannifin Corporation	Industrials
PAYX	Paychex Inc.	Information Technology
PYPL	PayPal Holdings Inc	Information Technology
PNR	Pentair plc	Industrials
PBCT	People's United Financial Inc.	Financials
PEP	PepsiCo Inc.	Consumer Staples
PKI	PerkinElmer Inc.	Health Care
PRGO	Perrigo Co. Plc	Health Care
PFE	Pfizer Inc.	Health Care
PM	Philip Morris International Inc.	Consumer Staples
PSX	Phillips 66	Energy
PNW	Pinnacle West Capital Corporation	Utilities
PXD	Pioneer Natural Resources Company	Energy
PNC	PNC Financial Services Group Inc.	Financials
PPG	PPG Industries Inc.	Materials
PPL	PPL Corporation	Utilities
PFG	Principal Financial Group Inc.	Financials
PG	Procter & Gamble Company	Consumer Staples
PGR	Progressive Corporation	Financials
PLD	Prologis Inc.	Real Estate
PRU	Prudential Financial Inc.	Financials
PEG	Public Service Enterprise Group Inc	Utilities
PSA	Public Storage	Real Estate
PHM	PulteGroup Inc.	Consumer Discretionary
PVH	PVH Corp.	Consumer Discretionary
QRVO	Qorvo Inc.	Information Technology
QCOM	QUALCOMM Incorporated	Information Technology
PWR	Quanta Services Inc.	Industrials
DGX	Quest Diagnostics Incorporated	Health Care
RL	Ralph Lauren Corporation Class A	Consumer Discretionary
RJF	Raymond James Financial Inc.	Financials
RTN	Raytheon Company	Industrials
O	Realty Income Corporation	Real Estate
RHT	Red Hat Inc.	Information Technology
REG	Regency Centers Corporation	Real Estate
REGN	Regeneron Pharmaceuticals Inc.	Health Care
RF	Regions Financial Corporation	Financials
RSG	Republic Services Inc.	Industrials
RMD	ResMed Inc.	Health Care
RHI	Robert Half International Inc.	Industrials
ROK	Rockwell Automation Inc.	Industrials
ROL	Rollins Inc.	Industrials
ROP	Roper Technologies Inc.	Industrials
ROST	Ross Stores Inc.	Consumer Discretionary
RCL	Royal Caribbean Cruises Ltd.	Consumer Discretionary
SPGI	S&P Global Inc.	Financials
CRM	salesforce.com inc.	Information Technology
SBAC	SBA Communications Corp. Class A	Real Estate
SLB	Schlumberger NV	Energy
STX	Seagate Technology PLC	Information Technology
SEE	Sealed Air Corporation	Materials
SRE	Sempra Energy	Utilities
SHW	Sherwin-Williams Company	Materials
SPG	Simon Property Group Inc.	Real Estate
SWKS	Skyworks Solutions Inc.	Information Technology
SLG	SL Green Realty Corp.	Real Estate
SNA	Snap-on Incorporated	Industrials
SO	Southern Company	Utilities
LUV	Southwest Airlines Co.	Industrials
SWK	Stanley Black & Decker Inc.	Industrials
SBUX	Starbucks Corporation	Consumer Discretionary
STT	State Street Corporation	Financials
SYK	Stryker Corporation	Health Care
STI	SunTrust Banks Inc.	Financials
SIVB	SVB Financial Group	Financials
SYMC	Symantec Corporation	Information Technology
SYF	Synchrony Financial	Financials
SNPS	Synopsys Inc.	Information Technology
SYY	Sysco Corporation	Consumer Staples
TROW	T. Rowe Price Group	Financials
TTWO	Take-Two Interactive Software Inc.	Communication Services
TPR	Tapestry Inc.	Consumer Discretionary
TGT	Target Corporation	Consumer Discretionary
TEL	TE Connectivity Ltd.	Information Technology
FTI	TechnipFMC Plc	Energy
TFX	Teleflex Incorporated	Health Care
TXN	Texas Instruments Incorporated	Information Technology
TXT	Textron Inc.	Industrials
TMO	Thermo Fisher Scientific Inc.	Health Care
TIF	Tiffany & Co.	Consumer Discretionary
TJX	TJX Companies Inc	Consumer Discretionary
TMK	Torchmark Corporation	Financials
TSS	Total System Services Inc.	Information Technology
TSCO	Tractor Supply Company	Consumer Discretionary
TDG	TransDigm Group Incorporated	Industrials
TRV	Travelers Companies Inc.	Financials
TRIP	TripAdvisor Inc.	Communication Services
TWTR	Twitter Inc.	Communication Services
TSN	Tyson Foods Inc. Class A	Consumer Staples
USB	U.S. Bancorp	Financials
CASH_USD	U.S. Dollar	Unassigned
UDR	UDR Inc.	Real Estate
ULTA	Ulta Beauty Inc	Consumer Discretionary
UAA	Under Armour Inc. Class A	Consumer Discretionary
UA	Under Armour Inc. Class C	Consumer Discretionary
UNP	Union Pacific Corporation	Industrials
UAL	United Continental Holdings Inc.	Industrials
UPS	United Parcel Service Inc. Class B	Industrials
URI	United Rentals Inc.	Industrials
UTX	United Technologies Corporation	Industrials
UNH	UnitedHealth Group Incorporated	Health Care
UHS	Universal Health Services Inc. Class B	Health Care
UNM	Unum Group	Financials
VFC	V.F. Corporation	Consumer Discretionary
VLO	Valero Energy Corporation	Energy
VAR	Varian Medical Systems Inc.	Health Care
VTR	Ventas Inc.	Real Estate
VRSN	VeriSign Inc.	Information Technology
VRSK	Verisk Analytics Inc	Industrials
VZ	Verizon Communications Inc.	Communication Services
VRTX	Vertex Pharmaceuticals Incorporated	Health Care
VIAB	Viacom Inc. Class B	Communication Services
V	Visa Inc. Class A	Information Technology
VNO	Vornado Realty Trust	Real Estate
VMC	Vulcan Materials Company	Materials
GWW	W.W. Grainger Inc.	Industrials
WBA	Walgreens Boots Alliance Inc	Consumer Staples
WMT	Walmart Inc.	Consumer Staples
DIS	Walt Disney Company	Communication Services
WM	Waste Management Inc.	Industrials
WAT	Waters Corporation	Health Care
WEC	WEC Energy Group Inc	Utilities
WCG	WellCare Health Plans Inc.	Health Care
WFC	Wells Fargo & Company	Financials
WELL	Welltower Inc.	Real Estate
WDC	Western Digital Corporation	Information Technology
WU	Western Union Company	Information Technology
WAB	Westinghouse Air Brake Technologies Corporation	Industrials
WRK	WestRock Company	Materials
WY	Weyerhaeuser Company	Real Estate
WHR	Whirlpool Corporation	Consumer Discretionary
WMB	Williams Companies Inc.	Energy
WLTW	Willis Towers Watson Public Limited Company	Financials
WYNN	Wynn Resorts Limited	Consumer Discretionary
XEL	Xcel Energy Inc.	Utilities
XRX	Xerox Corporation	Information Technology
XLNX	Xilinx Inc.	Information Technology
XYL	Xylem Inc.	Industrials
YUM	Yum! Brands Inc.	Consumer Discretionary
ZBH	Zimmer Biomet Holdings Inc.	Health Care
ZION	Zions Bancorporation N.A.	Financials
ZTS	Zoetis Inc. Class A	Health Care
